MaxCombo=최대 콤보
AvgTiming=평균 타이밍:
Score=점수
Accuracy=정확도
Spin=스핀
Combo=콤보
Hit=히트
DownloadMoreSongs=곡을 추가로 다운로드...
ErrorWhileDownloadingSongListing=곡 목록을 다운받는 중 에러가 발생했습니다.
HaveAllAvailableSongPacks=현재까지 나온 모든 팩들을 가지고 계십니다. 다음에 다시 확인해주세요!
Notice=공지
Yes=예
No=아니오
Okay=확인
Alert=주의
PlayCount=플레이 수:
HighScore=최고 점수:
YouCantFail=클리어 / 페일 여부에 상관없이 끝까지 플레이할 수 있습니다.
DynamicStreamSwitching=역동적인 스트림 스위칭!
NotForTheFaintHearted=노약자 및 임산부는 주의해주세요.
ExpertUnlock=Stream 모드에서 A나 더 높은 랭크를 받음으로써 Expert 모드를 잠금해제하세요!
GameCentreInactive=게임센터 비활성 상태
GameCentreInactiveExplanation=로그인이 안되어있거나 연결이 되지 않아 게임 센터가 현재 비활성화 되어있습니다. Options 메뉴를 통해 언제든지 로그인을 할 수 있습니다.
Loading=로딩중...
AndHoldUntilTheCircleExplodes=...그리고 원이 터질 때까지 누르고 계세요!
WelcomeToTheWorldOfOsu=osu!의 세계에 오신 것을 환영합니다. 이 튜토리얼은 당신이 리듬 마스터가 되기 위해 필요한 모든 것들을 가르쳐 줄 것입니다.
TapToContinue=계속하려면 화면을 눌러주세요.
Introduction2=osu! stream은 박자감각과 공간감각이 모두 필요한 게임입니다.
Introduction3=박자를 느껴야 하기 때문에 헤드폰을 착용하시거나 주변이 조용한 환경에서 플레이해주세요!
Introduction4=먼저 다른 종류의 비트를 살펴보는 것으로 시작합시다.
HitCircle1=히트서클은 osu!에서 가장 중요한 요소입니다.
HitCircle2=이는 메인 서클과...
HitCircle3=어프로치서클로 이루어져 있습니다.
HitCircle4=어프로치서클이 메인 서클의 가장자리에 닿을 때...
HitCircle4_1=서클을 눌러주시면 됩니다!
HitCircle5=서클을 누르는 타이밍이 정확할수록 더 높은 점수를 얻습니다!
HitCircle6=직접 시도해 볼까요? 다음 8개의 히트서클을 쳐 보세요.
