MaxCombo=Max Combo
AvgTiming=Śr. timing
Score=Punkty
Accuracy=Precyzja
Spin=Spin
Combo=Combo
Hit=Trafienie
DownloadMoreSongs=Pobierz więcej utworów...
ErrorWhileDownloadingSongListing=Wystąpił błąd podczas pobierania listy utworów...
HaveAllAvailableSongPacks=Posiadasz wszystkie dostępne paczki!\nSpróbuj ponownie później!
Notice=Informacja
Yes=Tak
No=Nie
Okay=Ok
Alert=Ostrzeżenie
PlayCount=Liczba gier:
HighScore=Max. punktów
YouCantFail=Nie możesz przegrać
DynamicStreamSwitching=Dynamiczna zmiania stream'u
NotForTheFaintHearted=Nie dla słabeuszy!
ExpertUnlock=Odblokuj tryb "Expert" uzyskując ranking A lub wyższy w trybie "Stream"!
Loading=Ładowanie...
AndHoldUntilTheCircleExplodes=...oraz przytrzymaj, do czasu kiedy okrąg wybuchnie!
WelcomeToTheWorldOfOsu=Witaj w świecie osu!.\nTen przewodnik nauczy Cię wszystkiego co potrzebujesz aby stać sie rytmicznym mistrzem!
TapToContinue=Dotnknij aby kontynuować!
Introduction2=osu!stream jest grą, która wymaga dokładności rytmicznej, zarówno jak i punktualnej.
Introduction3=Wczuj się w rytm! Graj wyłącznie w słuchawkach, lub w cichym otoczeniu!
Introduction4=Spójrzmy na typy beat'ów.
HitCircle1=Okręgi są podstawowym typem beat'ów w osu!.
HitCircle2=Zbudowane są z głównego okręgu...
HitCircle3=I atakującego okręgu.
HitCircle4=Gdy atakujący okręg dotrze do głównego okręgu...
HitCircle4_1=...dotknij go!
HitCircle5=Im więcej czasowo dokładne uderzenie jest, tym więcej punktów dostaniesz!
Good=Dobrze...
Great=Wspaniale!
Perfect=Perfekcyjnie!
HitCircle6=Ok! Spróbujmy!\nUderz te 8 okręgów!
HitCircleJudge1=Hmm, wygląda na to, że potrzebujemy więcej treningu. Spróbujmy jeszcze raz!
HitCircleJudge2=Nieźle!\nPrzyglądaj się dokładnie atakującemu okręgowi i słuchaj rytmu! Jeszcze raz!
HitCircleJudge4=Niesamowicie! Dobra robota!
