MaxCombo=Max Combo
AvgTiming=Gemiddelde timing:
Score=Score
Accuracy=Nauwkeurigheid
Spin=Spin
Combo=Combo
Hit=Hit
DownloadMoreSongs=Download meer liedjes...
ErrorWhileDownloadingSongListing=Fout tijdens het downloaden van de lijst van de liedjes.
HaveAllAvailableSongPacks=Je hebt alle beschikbare packs al.\nKom later terug!
Notice=Melding
Yes=Ja
No=Nee
Okay=Ok
Alert=Waarschuwing
HighScore=High Score:
YouCantFail=Je kunt niet verliezen.
ExpertUnlock=Speel "Expert" vrij door een A of hoger te halen in "Stream" mode.
Loading=Laden...
AndHoldUntilTheCircleExplodes=...en houd de cirkel vast tot hij explodeert!
WelcomeToTheWorldOfOsu=Welkom in de wereld van osu!.\n Deze tutorial zal je alles wat je moet weten leren om een ware "rhythm master" te worden.
TapToContinue=Tap om verder te gaan!
Introduction2=osu!stream is een spel waar je zowel ritmische als positionele accuratesse voor nodig hebt.
Introduction3=Je zult het ritme moeten voelen, zorg ervoor dat je een hoofdtelefoon gebruikt of in een rustige omgeving speelt.
Introduction4=Laten we beginnen met naar de verschillende soorten beats te kijken.
Good=Goed...
Great=Super!
Perfect=Perfect!
HitCircleJudge4=Vlekkeloos! Goed gedaan!
Hold3=Nu met twee vingers!
Slider3=Sommige sliders moeten worden herhaald.
Slider3_1=Soms moet je ze meerdere malen herhalen.
Slider3_2=Dit zal worden aangekondigd d.m.v. een pijl aan het eind.
Slider4=Laten we wat sliders proberen!
SliderJudge2=Zorg er voor dat je de bal volgt met je vinger! Laten we nog eens nog eens proberen.
Thumbs=duimen
Fingers=vingers
Healthbar1=De levensbalk bevind zich in de linkerbovenhoek van het scherm.
Score1=Je score is gebaseerd op je nauwkeurigheid en combo.
TimingEarly=Een beetje vroeg..
TimingLate=Een beetje laat..
TimingVeryEarly=Erg vroeg..
TimingVeryLate=Erg laat..
UseGuideFingers_Explanation=Wil je vingerbegeleiding aan laten terwijl je speelt? Dit maakt het wat makkelijker voor beginners.
Je kunt dit op elk moment aan- en uitzetten in de opties.
About=Over
OnlineHelp=Online Help
DifficultySettings=Moeilijkheidsgraad
Credits=Credits
EffectVolume=Effecten volume
MusicVolume=Muziek volume
OnlineOptions=Online
Free=Gratis
Congratulations=Gefeliciteerd!
UnlockedExpert=Je hebt expert mode voor dit liedje uitgespeeld.
Veel succes!
Audio=Audio
NoticeOnlineRanking=Door onverwachte omstandigheden zullen highscores pas in versie 1.1 worden toegevoegd. Sorry voor het ongemak!
FirstRunTutorial=Als dit de eerste keer is dat je speelt, is het aan te raden om de tutorial te doen, en de basisvaardigheden te leren. Wat vind je er van?
MorePractice=Het ziet er naar uit dat je meer moet oefenen. Laten we het nog eens proberen!
Update=Update
ExitTutorial=Weet je zeker dat je de tutorial wilt verlaten?
Twitter=Log in via twitter voor de volledige online functionaliteit, inclusief avatars en de mogelijkheid om meerdere apparaten te koppelen!
TwitterUnlink=Ontkoppel '{0}'
Cancel=Annuleren
GuestUsername=Stel (gasten) gebruikersnaam in
ChooseUsername=Kies een gebruikersnaam!
InternetFailed=Laden mislukt.\nControleer of je verbonden bent met het internet en probeer het later nog eens.
Crashed=Het ziet er naar uit dat er iets mis is gegaan.
Details zullen opgestuurd worden naar peppy (de maker van osu!stream) zodat het opgelost kan worden. Sorry voor de omstandigheden!
AppleReallyScrewedThisUp1=Het ziet er naar uit dat een aantal van je liedjes zijn verwijderd. Dit is een **unfortunate behaviour** van iOS 5 welke niet omzeild kan worden. Bezoek de store om je liedjes gratis overnieuw te downloaden.
AccessNotGrantedDetails=Je hebt osu!stream geen toegang gegeven, Ã³f je hebt geen twitter account ingesteld staan. Wil je handmatig koppelen door in te loggen?
TwitterLinkQuestionDetails=Koppel aan {0}?
TwitterSuccess=Koppelen gelukt!
TwitterSuccessDetails=Nu gekoppeld aan {0}.
